00000000000000000000000000000000
00000000000000000000000000000000
00000000000000000000000000000000
00000000000000000000000000000000
00000000000000000000000000000000
00000000000000000000000000000000
00000000000000000000000000000000
00000000000000000000000000000000
00000000000000000000000000000001
00000000000000000000000000000011
00000000000000000000000000001111
00000000000000000010100011111111
00000000000001111111111111111111
11111000011111111111111000000001
11111110000000000000000000000001
11111111111111111111111111111111